11110
100C1
1P101
100E1
11111
