111111111111111111111111111111111111111111111111111111111111111111111
100000000000000000000000000000000000000000000000001000000000000000011
100C00000000000000000000000000000000000000000000000100000000000000011
100000000000000000000000000000000000000000000000000010000000000000011
100000000000000000000000000000000000000E00000000000001000000000000011
100000000000000000000000000000000000000000000000000000100000000000011
100000000000000000000000000000000000000000000000P00000010000000000011
100000000000000000000000000000000000000000000000000000001000000000011
100000000000000000000000000000000000000000000000000000000100000000011
100000000000000000000000000000000000000000000000000000000010000000011
100000000000000000000000000000000000000000000000000000000010000000011
100000000000000000000000000000000000000000000000000000000001000000011
100000000000000000000000000000000000000000000000000000000000100000011
100000000000000000000000000000000000000000000000000000000000000000111
100000000000000000000000000000000000000000000000000000000000010000011
100000000000000000000000000000000000000000000000000000000000001000011
100000000000000000000000000000000000000000000000000000000000000100011
100000000000000000000000000000000000000000000000000000000000000010011
100000000000000000000000000000000000000000000000000000000000000001011
100000000000000000000000000000000000000000000000000000000010000000011
100000000000000000000000000000000000000000000000000000000100000000011
100000000000000000000000000000000000000000000000000000001000000000011
100000000000000000000000000000000000000000000000000000010000000000011
100000000000000000000000000000000000000000000000000000100000000000011
100000000000000000000000000000000000000000000000000001000000000000011
100000000000000000000000000000000000000000000000000010000000000000011
100000000000000000000000000000000000000000000000000100000000000000001
100000000000000000000000000000000000000000000000001000000000000000011
100000000000000000000000000000000000000000000000010000000000000000001
100000000000000000000000000000000000000000000000100000000000000000001
100000000000000000000000000000000000000000000001000000000000000000001
100000000000000000000000000000000000000000000010000000000000000000001
100000000000000000000000000000000000000000000010000000000000000000001
100000000000000000000000000000000000000000000010000000000000000000001
111111111111111111111111111111111111111111111111111111111111111111111