1111111
11P1001
1111C01
10E0001
1111111