11111111
10P00001
100C0001
100000011
100E0001
11111111