1111111111111111111111111111111111111111111111111111111111111111111111
1000000000000000000000000000000000000000000000000010000000000000000111
100C000000000000000000000000000000000000000000000001000000000000000111
1000000000000000000000000000000000000000000000000000100000000000000111
100000000000000000000000000000000000000E000000000000010000000000000111
1000000000000000000000000000000000000000000000000000001000000000000111
100000000000000000000000000000000000000000000000P000000100000000000111
1000000000000000000000000000000000000000000000000000000010000000000111
1000000000000000000000000000000000000000000000000000000001000000000111
1000000000000000000000000000000000000000000000000000000000100000000111
1000000000000000000000000000000000000000000000000000000000100000000111
1000000000000000000000000000000000000000000000000000000000010000000111
1000000000000000000000000000000000000000000000000000000000001000000111
1000000000000000000000000000000000000000000000000000000000000000001111
1000000000000000000000000000000000000000000000000000000000000100000111
1000000000000000000000000000000000000000000000000000000000000010000111
1000000000000000000000000000000000000000000000000000000000000001000111
1000000000000000000000000000000000000000000000000000000000000000100111
1000000000000000000000000000000000000000000000000000000000000000010111
1000000000000000000000000000000000000000000000000000000000100000000111
1000000000000000000000000000000000000000000000000000000001000000000111
1000000000000000000000000000000000000000000000000000000010000000000111
1000000000000000000000000000000000000000000000000000000100000000000111
1000000000000000000000000000000000000000000000000000001000000000000111
1000000000000000000000000000000000000000000000000000010000000000000111
1000000000000000000000000000000000000000000000000000100000000000000111
1000000000000000000000000000000000000000000000000001000000000000000011
1000000000000000000000000000000000000000000000000010000000000000000111
1000000000000000000000000000000000000000000000000100000000000000000011
1000000000000000000000000000000000000000000000001000000000000000000011
1000000000000000000000000000000000000000000000010000000000000000000011
1000000000000000000000000000000000000000000000100000000000000000000011
1000000000000000000000000000000000000000000000100000000000000000000011
1000000000000000000000000000000000000000000000100000000000000000000011
1000000000000000000000000000000000000000000000100000000000000000000011
1111111111111111111111111111111111111111111111111111111111111111111111