1111111
1000010
10D0001
1111111