1111111
1000010
1000001
1111111