11111111111111111111111111111111111111
10000000000000000000000000000000000001
100000000100000C0C010000011C0C0C000001
10000000101000C00001000100100000000001
10P00001001000000001000100100000000001
100000100010000000010000111C0C0C000001
100001011C1000C00001000000100000000001
10000000001000000001000000100000000001
10000C00001000C00001000000100000000001
10000C0C0C100000C0C10000001C0C0C000001
1000000000000000000000000000000000E001
11111111111111111111111111111111111111