1111111111111111111111
1000010000000000100001
10000C00000C0000C00001
1000011111C11111100001
1000000001010000000001
10000P0001010000000001
1000000001C10000000001
1000000010001000000001
10000001C0C0C100000001
1000000010001000000001
1000000001C10000000001
1000C0000101000000C001
1000000001010000000001
1000000110001100000001
1000000110E01100000001
1111111111111111111111