1111111111111111111111111111111111
1000000000000000000000000000000001
10P011111111111111111111111C000001
1000100001000100010000100000110001
1000C0C00100010C010000010000110001
1000CCCC01000100011111100000110001
1000C00001000100010000C00000110001
1000C00C010001000110000000001000E1
1000CCCCC1CCC1CCC11111111111000001
1000000000000000000000000000000001
1111111111111111111111111111111111