1111111
10P0001
1000C01
10E0001
1111111